WVVVWVVVVW
VVVVVVVVVV
VVVVWVWVWV
VVVVVVVVVV
VVVVVVWVVV
VWVVVVVVVW
VVVVVVVVVV
VVWVVVVVVV
WVVVVVVVWW
WWWVVVVWWW
